011111101111110111111011111101111110
111111000000000000000000000000000000
111111111111110011110011111111111111
100001111111100001100001100001100001
111111101101111111111111101101111111
001100101101001100001100011110001100
010010010010110011010010010010011110
111100101101111100111100101110111100
100001001110011010010110011100100001
000010111111010000000010010000111111
101110111111111111111111010000000001